pitch_map_json = {
    "EFM": {
        "BD": {
            "A#1": 6,
            "A#2": 38,
            "A#3": 70,
            "A#4": 102,
            "A-1": 3,
            "A-2": 35,
            "A-3": 67,
            "A-4": 99,
            "B-1": 9,
            "B-2": 41,
            "B-3": 73,
            "B-4": 105,
            "C#2": 14,
            "C#3": 46,
            "C#4": 78,
            "C#5": 110,
            "C-2": 11,
            "C-3": 43,
            "C-4": 75,
            "C-5": 107,
            "D#2": 19,
            "D#3": 51,
            "D#4": 83,
            "D#5": 115,
            "D-2": 17,
            "D-3": 49,
            "D-4": 81,
            "D-5": 113,
            "E-2": 22,
            "E-3": 54,
            "E-4": 86,
            "E-5": 118,
            "F#2": 27,
            "F#3": 59,
            "F#4": 91,
            "F-2": 25,
            "F-3": 57,
            "F-4": 89,
            "G#1": 1,
            "G#2": 33,
            "G#3": 65,
            "G#4": 97,
            "G-2": 30,
            "G-3": 62,
            "G-4": 94
        },
        "CP": {
            "A#4": 22,
            "A#5": 45,
            "A#6": 68,
            "A#7": 92,
            "A#8": 115,
            "A-4": 20,
            "A-5": 43,
            "A-6": 66,
            "A-7": 90,
            "A-8": 113,
            "B-3": 0,
            "B-4": 24,
            "B-5": 47,
            "B-6": 70,
            "B-7": 94,
            "B-8": 117,
            "C#4": 4,
            "C#5": 28,
            "C#6": 51,
            "C#7": 74,
            "C#8": 97,
            "C#9": 121,
            "C-4": 2,
            "C-5": 26,
            "C-6": 49,
            "C-7": 72,
            "C-8": 95,
            "C-9": 119,
            "D#4": 8,
            "D#5": 31,
            "D#6": 55,
            "D#7": 78,
            "D#8": 101,
            "D#9": 125,
            "D-4": 6,
            "D-5": 29,
            "D-6": 53,
            "D-7": 76,
            "D-8": 99,
            "D-9": 123,
            "E-4": 10,
            "E-5": 33,
            "E-6": 57,
            "E-7": 80,
            "E-8": 103,
            "E-9": 127,
            "F#4": 14,
            "F#5": 37,
            "F#6": 61,
            "F#7": 84,
            "F#8": 107,
            "F-4": 12,
            "F-5": 35,
            "F-6": 59,
            "F-7": 82,
            "F-8": 105,
            "G#4": 18,
            "G#5": 41,
            "G#6": 64,
            "G#7": 88,
            "G#8": 111,
            "G-4": 16,
            "G-5": 39,
            "G-6": 62,
            "G-7": 86,
            "G-8": 109
        },
        "HH": {
            "A#5": 48,
            "A#6": 99,
            "A-5": 44,
            "A-6": 95,
            "B-4": 1,
            "B-5": 52,
            "B-6": 103,
            "C#5": 9,
            "C#6": 61,
            "C#7": 112,
            "C-5": 5,
            "C-6": 56,
            "C-7": 108,
            "D#5": 18,
            "D#6": 69,
            "D#7": 120,
            "D-5": 14,
            "D-6": 65,
            "D-7": 116,
            "E-5": 22,
            "E-6": 73,
            "E-7": 125,
            "F#5": 31,
            "F#6": 82,
            "F-5": 27,
            "F-6": 78,
            "G#5": 39,
            "G#6": 91,
            "G-5": 35,
            "G-6": 86
        },
        "RS": {
            "A#5": 30,
            "A#6": 62,
            "A#7": 94,
            "A#8": 126,
            "A-5": 27,
            "A-6": 59,
            "A-7": 91,
            "A-8": 123,
            "B-4": 1,
            "B-5": 33,
            "B-6": 65,
            "B-7": 97,
            "C#5": 6,
            "C#6": 38,
            "C#7": 70,
            "C#8": 102,
            "C-5": 3,
            "C-6": 35,
            "C-7": 67,
            "C-8": 99,
            "D#5": 11,
            "D#6": 43,
            "D#7": 75,
            "D#8": 107,
            "D-5": 9,
            "D-6": 41,
            "D-7": 73,
            "D-8": 105,
            "E-5": 14,
            "E-6": 46,
            "E-7": 78,
            "E-8": 110,
            "F#5": 19,
            "F#6": 51,
            "F#7": 83,
            "F#8": 115,
            "F-5": 17,
            "F-6": 49,
            "F-7": 81,
            "F-8": 113,
            "G#5": 25,
            "G#6": 57,
            "G#7": 89,
            "G#8": 121,
            "G-5": 22,
            "G-6": 54,
            "G-7": 86,
            "G-8": 118
        },
        "SD": {
            "A#4": 48,
            "A#5": 99,
            "A-4": 44,
            "A-5": 95,
            "B-3": 1,
            "B-4": 52,
            "B-5": 103,
            "C#4": 9,
            "C#5": 61,
            "C#6": 112,
            "C-4": 5,
            "C-5": 56,
            "C-6": 108,
            "D#4": 18,
            "D#5": 69,
            "D#6": 120,
            "D-4": 14,
            "D-5": 65,
            "D-6": 116,
            "E-4": 22,
            "E-5": 73,
            "E-6": 125,
            "F#4": 31,
            "F#5": 82,
            "F-4": 27,
            "F-5": 78,
            "G#4": 39,
            "G#5": 91,
            "G-4": 35,
            "G-5": 86
        },
        "XT": {
            "A#2": 28,
            "A#3": 92,
            "A-2": 23,
            "A-3": 87,
            "B-2": 33,
            "B-3": 97,
            "C#3": 44,
            "C#4": 108,
            "C-3": 39,
            "C-4": 102,
            "D#3": 55,
            "D#4": 118,
            "D-3": 49,
            "D-4": 113,
            "E-3": 60,
            "E-4": 124,
            "F#2": 7,
            "F#3": 71,
            "F-2": 1,
            "F-3": 65,
            "G#2": 17,
            "G#3": 81,
            "G-2": 12,
            "G-3": 76
        }
    },
    "TRX": {
        "BD": {
            "A#2": 60,
            "A#3": 124,
            "A-2": 55,
            "A-3": 119,
            "B-1": 1,
            "B-2": 66,
            "C#2": 12,
            "C#3": 76,
            "C-2": 7,
            "C-3": 71,
            "D#2": 23,
            "D#3": 87,
            "D-2": 17,
            "D-3": 82,
            "E-2": 28,
            "E-3": 92,
            "F#2": 39,
            "F#3": 103,
            "F-2": 33,
            "F-3": 98,
            "G#2": 49,
            "G#3": 114,
            "G-2": 44,
            "G-3": 108
        },
        "CL": {
            "A#7": 72,
            "A-7": 66,
            "B-6": 5,
            "B-7": 78,
            "C#7": 17,
            "C#8": 91,
            "C-7": 11,
            "C-8": 84,
            "D#7": 29,
            "D#8": 103,
            "D-7": 23,
            "D-8": 97,
            "E-7": 36,
            "E-8": 109,
            "F#7": 48,
            "F#8": 121,
            "F-7": 42,
            "F-8": 115,
            "G#7": 60,
            "G-7": 54,
            "G-8": 127
        },
        "RS": {
            "A#4": 56,
            "A-4": 45,
            "B-4": 67,
            "C#5": 88,
            "C-5": 77,
            "D#5": 109,
            "D-5": 98,
            "E-5": 120,
            "F#4": 13,
            "F#5": 123,
            "F-4": 3,
            "F-5": 121,
            "G#4": 35,
            "G-4": 24,
            "G-5": 126
        },
        "SD": {
            "A#4": 56,
            "A-4": 45,
            "B-4": 67,
            "C#5": 88,
            "C-5": 77,
            "D#5": 109,
            "D-5": 98,
            "E-5": 120,
            "F#4": 13,
            "F#5": 123,
            "F-4": 3,
            "F-5": 121,
            "G#4": 35,
            "G-4": 24,
            "G-5": 126
        },
        "XC": {
            "A#3": 27,
            "A#4": 92,
            "A-3": 22,
            "A-4": 86,
            "B-3": 33,
            "B-4": 97,
            "C#4": 43,
            "C#5": 108,
            "C-4": 38,
            "C-5": 102,
            "D#4": 54,
            "D#5": 118,
            "D-4": 49,
            "D-5": 113,
            "E-4": 60,
            "E-5": 124,
            "F#3": 6,
            "F#4": 70,
            "F-3": 1,
            "F-4": 65,
            "G#3": 17,
            "G#4": 81,
            "G-3": 11,
            "G-4": 76
        },
        "XT": {
            "A#3": 44,
            "A#4": 108,
            "A-3": 39,
            "A-4": 103,
            "B-3": 49,
            "B-4": 113,
            "C#4": 60,
            "C#5": 124,
            "C-4": 55,
            "C-5": 118,
            "D#3": 7,
            "D#4": 71,
            "D-3": 2,
            "D-4": 65,
            "E-3": 12,
            "E-4": 76,
            "F#3": 23,
            "F#4": 87,
            "F-3": 18,
            "F-4": 81,
            "G#3": 34,
            "G#4": 97,
            "G-3": 28,
            "G-4": 92
        }
    }
}
